%%%%%%%%%%%%%%%%%%%%%%%%%%%%%%%%%%%%%%%%%%
%.%  .%.%  %.%.%   %  %.. %.    %       6%
%   %     .           %%     %%  .%.%% %4%
% % %%%%%%%%%%%%%         % .   % %%%  %2%
% % %..  ..%.      %    %%%%%% %%.%.%  % %
% % %%%% %%%.%.%   %  %     %   % %.% %% %
%   %      %%%%%%% %   .%%.     % %o% .% %
%% .         o.       % %   % . % % % %% %
%.  % .  . %    .  %  %.   %%% %%   %  %.%
%%%%%%%%  %%% %% %%%    %  .%...%.%    % %
%  ..%..      . .     % %%%%%%%%%%%%%%%%.%
%.%%%%%%%%%%%%%%%% %     . .      ..%..  %
% %    %.%...%.  %    %%% %% %%%  %%%%%%%%
%.%  %   %% %%%   .%  %  .    % .  . %  .%
% %% % % % . %   % %       .o         . %%
% %. %o% %     .%%.   % %%%%%%%      %   %
% %% %.% %   %     %  %   %.%.%%% %%%% % %
% %  %.%.%% %%%%%%    %      .%..  ..% % %
%1%  %%% %   . %         %%%%%%%%%%%%% % %
%3% %%.%.  %%     %%           .     %   %
%5       %    .% ..%  %   %.%.%  %.%.  %.%
%%%%%%%%%%%%%%%%%%%%%%%%%%%%%%%%%%%%%%%%%%